############
#        O #
#   P   ####
#          ############
#######               #
#  O ##               #
#    ##    ############
#          #
#       XX #
#       #  #
############
